5000000000000000000000004
5000000000000000000000004
5000000000000000000000004
5000000000000000000000004
5000000000000000000000004
5000000000000000000000004
5000000000000000000000004
5000000000000000000000004
5000000000000000000000004
5000000000000000000000004
5000000000000000000000004
5P00000000000000000000004
0==========]0000000000004
5000000000000000000000004
5000000000000000000000004
5000000000000000000000004
5000000000000ccccccccc0D4
2111111111111111111111113