5000000000000000000000004
5000000000000000000000004
5000000000000000000000004
5000000000000000000000004
5P00000000cccc00000000004
0=======#======]000000004
50000000H00000000000[#]04
50000000H000000000000H004
50000000H000000000>00H@<4
50000000H00ggg0000[=#===0
5>@00000H00000<00000H0004
0=============]00000H0004
50000000000000000[===]0c4
50000000000000000000000g4
50000000000000000000000c4
500000gggggggg000000000[0
5000>000000000000@<0000D4
2111111111111111111111113